2017-12-15	1
2017-12-15	1
2017-12-12	1
2017-12-13	1
2017-12-13	1
2017-12-12	1
2017-12-18	1
2017-12-21	1
2017-12-17	1
2017-12-14	1
2017-12-16	1
2017-12-11	1
2017-12-20	1
2017-12-20	1
2017-12-21	1
2017-12-13	1
2017-12-12	1
2017-12-21	1
2017-12-14	1
2017-12-17	1
2017-12-12	1
2017-12-16	1
2017-12-20	1
2017-12-17	1
2017-12-17	1
2017-12-14	1
2017-12-20	1
2017-12-19	1
2017-12-21	1
2017-12-12	1
2017-12-17	1
2017-12-19	1
2017-12-16	1
2017-12-17	1
2017-12-11	1
2017-12-15	1
2017-12-20	1
2017-12-16	1
2017-12-12	1
